--------
|      |
|      E
|      |
|      |
|  T   |
|      |
|      |
|      |
|      |
---S----