---N----
|      |
W      |
|      |
|      E
|      |
|      |
---S----