---------------
|             |
|          T  |
|             |
|  ---   ------
|  |x|   |
|S-|x|-S-|