----N----
|       |
|  T T  |
|       |
|       |
|       |
|       |
----S----